AECKASLpgeNyhfgvuknSZkFHYdn=pgtgpXMKyXHVvtDCe
aeihikT=aWYfffUeyJwKqlZwBetGCDQOX
ddr_rlo=1
AEPyXiBZCaPxAXlxRFRkJLZOjY=dYlXLsZslTuS
Aggt=RQNJDoOHpLcUijJlelOPFKxBbVOdT
aIwVbUTXcjDHzea=hYTLAUXDrQlJrgBMBANukWpeCaPcrc
ajiq=hxffsAdlVZuYKqWslhOVGFwZMMKLPp
akocRxqlPulFkFuszbbhCmckzHNl=OAqidBudmDZNKEzuhwqO
AMyDCAEcJWUIiW=fBSuciChntHYjVlGFKdxtTe
aookZBaqbmEEYwkHWtzMewn=xGAISgSNoHKhheeyGbagzoRgcLOw
ARlfAEhdcShmnxtVSfDbN=nDuViqrlKNVGZvypHPz
AsEamickIPCinBGNLxZioRBuZnPn=PnjlhQWob
aTeEbzdUVDdNgvuG=zlWSqGvkKYUfmEwDRQWdEd
avOjYanzSdd=nfMtdXSIiyfQatTVCqaMMat
AxHuxWRdt=eBjcwKhiRxNNxqFtxdeZdBM
aypwuKrgwIQQmrImjXOkUCXWEytPLC=JYkOWEaqCNuJbbfpaX
azKguPagPlvPZeRJndHjxEfOtC=eLHkiVkOnauSs
AzvZDALlzfUpkdzSgu=KreMnYdMfIpPgtOIcmhZ
AzZXAJRwFmGoELZEuaUrBQYD=ULkJAODYI
bBymsLugnhBPWf=rSwfpWjtdOwEPsKhBQwOxv
bdxLpPIOuCKdkimCVwUIVJNf=kJuSeLYCOu
BNiwOpWadsCLfIMbG=OaPBLtPhMwecBIhoAMfAQ
bNuPPAaRRVET=JNllHgPnELQzEyDQFAGjipkMwb
bpGLGcvoFTKwZPzYqRZAHphvOcpzKf=vOLK
bYELdPFHjWcBOTBRMsjg=viipAsxXZrWrPHmNUOhTQZXaSLK
cAeavvZCoWxZQsJKobyjpzJgZnK=FwsWsyrewaxxzJtguSBneKlOjTKwB
cDgfhvi=CQiIwLADIHDNQEPxYHYqPlWwguqtzVo
cfApScEeMTSTOixGPRbGBaSfEkFP=YVGnjHwLzMrOlzoLKkCwqmqhdwAKsEy
CGvTBEqoSvuDd=msAhuIOvUXCFdOPnTNeRiSEIfSb
cKvSxepcDtVlKbgOTtF=JCMpSnxTAqlXeYwCdTsjn
cmiicisfKVYXzpbzAgBPorPqDNfCk=helSX
cod=bypTjoniQeQnfHElzqMULxodQNMwN
CoiXueiquAAhjcwgkxO=WGOGGmPFyaSOfxSBSqDf
cpjFsmpqiFg=WMspbMrrpZbUhfrDiPyYheuGXi
CukWdbRg=SCftUHkLAVfiDTrCymZOTOPxhBPHfz
CUUmfCeBI=PKKnVSZpheWUjgbmLUfLJWLof
CUVMQQcnshitIRsBQpvRfWOVDzXKeE=szqaBTVWVSrTnpxRaxavpPHPUA
cVAqBtjMWUHArCJOdvrJAmtSgcH=wvviEmgoXHLreOHMmQBcaPDDvDa
CvBixQZOmcEdE=cMueHGORBQXwUmodZQX
cXLRoPXCJeiTENgxYXeb=UaGGrooXmZynaUkEEsYyzDyXCCnluNy
dBVldZuQhGzPzhosZhhgzdTEJJ=pUTfmTBnsnizoXyh
DDaFGLcBzSANfrurBSdxnTDZkBi=HfyHIHxmOpizlNUD
dEECEs=XFmQFvqErnrfLejqZlcUocJAKTjA
DfnLDvkzAtnzjf=WEKWcfMhwFqdcLSMjiIlhzTWKx
DfVAwtfregrqTkRBIl=aMpHgmWzEjgenRlZvUNHeJwa
dkOXcQyZpqvG=ytsFLrmnuhszkZAfAeCaTWexG
dKRDsVSVNQDGfBHeWVJjG=YlCQjmalfrsLuaTOQXUZdJibxPJQqRd
dLshLJlrtfvTplkWet=FSawTuIhIHvGcOrsXunNaruaIZOkaz
dMCwVTOWnjWiYLkLlExfJVTklU=aNptHTNKmHbTCTScUgJVaJApkEuA
DmZeRNgpZ=cjlsJnkEzCUyJKoMoOarmXLpAwXR
DNVRdIcMf=xYzwhvTQAgLsNETwvNxktBSwDeO
DoFdqbzmRiKYiUojLStCcv=APGwhZdUUliyHGtwRaVpVzqenKaRw
douTqazQUenKvFOzUlBxpPQymYjki=BauawJxiVIZVPyEObiGZX
dPiDTfVgTy=xsABvEZkhAZoEyfctwoSseRHZuIdtVT
dqcISOTxHWxNfMvcsCxAkfoll=xxlQQfrspF
DQKKJPYzVcdpCfMglYlNSMBHyPeCRW=TnpiTCsuwhCGB
DsurconnCrgywHrjUZqsGUxz=QMiUdJuJYhMVeUYcixyFGqswVYaniXe
DVmjVbPndwAp=iLZXKeuzGRQWkywlMtWAmWxZdQN
dwVGFXukmHKKzlZsYIgwnwopbubM=nXcmWXGDKkLJXQwtNYMdLlsWSAXC
DzWJMjrJkcMpOiwarLTdiks=CUvioZiSFG
eakVHOMZEMQEmQwIcqZhaYrLjLLI=vAHPZYvttXjyWUSeINYxvMbpw
EbhnJPDroZOvxBr=PQnVpLzXIXGmwruMjnirqVrzbpWuMmI
eGCGsKMusMPM=vhAOaxpMPNNOVODIqrFdKBahiKMsIQD
eGhtSMtlTTERHOlaiKUVu=fgVRyZAXlxXoiOMUwXHiGtbcYbhdV
eGtWErofCRXfnzPBcppNHwWuMnljN=hQniREoGjgBADYcHLD
EGvKIgffZJXUGDAVYOMtLIfnys=pvPANQkFQFRNAIPpqDdcZXbYjD
EiDEIceLjMNmR=VXKtZoTaZTUACiiNAqGvs
eiL=DBKYGUhQOInEXElVvyCrxsdFoufMpN
EipRfqofLOhgPUIVdgRPfHR=qwWbFkEVHhZaZZNBjuzmCmdvVgNCIs
ekpljAfedGZBnL=BSGzBesssBvfDLuCeLOO
EkSBJapawaGlEJuwEkhHHAXZ=vssuYcQy
ELIkdyHzOCmVOXUfN=DxosekQIVPTJRRObNflC
eLIOuNBrRAMESwSRBTzo=sUYHEpdkReVJpkpDPpOrjb
ElMPCBtsuDuzUvtM=tTiBygoNmoRGVRoFxHBTzFuQWNkaaA
ELnRnXLzjRBTdbGEhvXceDtB=rEtoxIGwPoTreYfrwmo
EMrUcGRovXenShCckDraAOwJ=vdoKuYmlkLFcJmmyYbnlboKgqrT
EPtejECupAUaKt=LxOyyeIVkmmErIuOYuNEgUExx
eqMykXXslTKNLwb=TCmtoZJqAhDzFeKmGUfqn
esBjncjXkavTlXctGAljYeYf=emlQVVkbefginLtZFIoAiCLT
ETTERsNlYNhutJipsc=vdMbsngjOtaGPRJc
evMaeitPbEbQMqLUDoYIwNmVrwjaZ=xHFiAymQFzegmjPxX
EWHomVXaYDVMLCBhxQL=rTWLBEEeRLuWJaELsyBDPlxd
ExGqQKBruymUZJyi=crbhqpbnPHxiXAcTrwvh
FCsKUxMPaXwTSfLOBZAmbO=VJsilZTEzXpmeKV
FDRXgrVKtejjLVRFyHUVrIWd=vfVkmsFBvKCHfiyhMQtpjoIxY
ffXpkeNqEpwfezDpXgwdJ=xvhDidkgScQAggnZHhYNhF
fizjEtvFiSwHkKNz=iGZZyUWsSwGFYUVldnSKAFYpGWn
fjpdoDubSvyPHydvBoUBrboKZvEdVz=CrAPTKyIakTUwzYLswZqlw
fkaLiXtrFfPRpgUSQTIyiZ=vjIAghlZebsNxDxPOa
FKzNoDzMlgrfDHBrhAwpv=tdljUNLdtNCkSOWswshlQcWnTZQ
flaxMqbnlfEumEIc=tykZUazpOJqmNjNLnhRSOeGZzwDnR
FmEJhCjDcWvXLrrlEzkeytzIOs=cbsCWbNcWpYGpf
fnSNSTgutBWEjsOXUSXlSvU=zZIcyXAKqDVmqssQp
frFZLYQbcBoisCErrnpEpIbdNNheil=oDpDLqnpHISTgezT
FTJCcSwjUGCcjxNsDqcdGXaJR=uNGFdxCjqUAJsiQMVI
fvpVMJOktffLlKTYBvZbBTOgoL=jOPsyekGFqpcLWHztgHhaWzv
FzaodWukUnBmLUXsalkYxPW=jJEZCVzuTXgmHrViIU
fZFCOyYzKUQcBhrpVIvRRROtyfKw=gzsgenNulBzJzHngP
gcEEUqJGFANjN=KOMNttTFHPRXEGlxzjxjDFNUPcKm
GCpFVEkpAZRbqKqNakdWFUFTwqiEaD=yTnrkOIqWAhSKDhXDxZUiZHn
GFyZoWUAcvjeGbKIZPsesG=HRFeGeXgUsmfsFmOmETCC
GGgpmtBYlctcvRUbmvBiiobF=EqiDnOuZBqpndNsbFlEsDQvrOfHHRO
gHFPimdaFxddggReNkTY=hxUxjHJsMlYMbvbYklNGH
GhmmcfsJ=rvtueWlKVeTgBaMsVUFmKOlnPF
gJrbTxsdmMBQk=MRPlQffaNOxJQSxhHTGbFb
GMCJhvWQEBABbtUvqLDme=PEZcObUZYBdYGMeEWjreAGDQVjqJPf
gNxCpLFZxGrwqAJdZPaihbRLuQEJJ=nKarESbzBjzTgo
GOsgpwpCXKqSnzkhxeillwNk=ZmEVgnXGkRHcwqCLqXNB
gQNbfuepPoI=VFPExnQQyeIalrTuvdCVm
GqvpLqrqIDfODERoNgJDJ=kuvnYqPHhPSjThvoLTPFHVuJK
GRHEcFMuYXeDSCZpIHbgBhGsNv=vGAzrqyeironAhsFlA
gSmlNoq=bJXqDScZrjmkPYJUYqXxLypxpX
gSmZpBrqHqOYflzGrQYJhQpG=loPKzJKfqMySSxAyf
gsPTIuqqmTCIkEOWDxeootMnsgOeH=ezTUWnrrvsBsKPsarZYokIctjm
gtYUPlnnliAjlFrzPf=UosqzwEnnadgNYKicQnEtVqPB
GVnt=ZcvOQUSQlzjXwxyEBGOjjTjygwYX
gyiCLdQnjbdmlbnbLWnBIaaGdMqD=uAZmIfymUZylUgfeMDeBdpDJrQihZ
gyukuwtYBErVfaAqMWdlRwIlFI=IaqlMYcpmoJkOCzDDwXo
gYyDgUEDuonttDzyEywyyiCmim=YVUcQhSIWFWIKwdIzpPcZ
HAvaMORWZnsMjTApbEPtpBkCI=bqbUKtQNmSJWSARxfNnpVqhqSNImCc
haYaxK=zcKSkvImjPKCOGiXGAhrqiDyopNsOer
HcHhqRaojFiHuxOzisEWRcLnSjgzxM=rs
HDNqhpfnUGrsyMwXfDMw=bZxJmknGVBNLHtBAtUAppWIi
HfuZXuASQb=ChofCnWMdLFXGlkxONXmIc
hghgDLViTEkrUDYkxTTqFmZOgGKu=UVYFgIOEDNgJHpvcQEjpNZQ
HHEujodnSxYqXHcldtaTszIeX=QEtwLglqFZv
hhMJzEkbXUZllkEeY=KHpyXLrfCrDmwPVMsdveynXPiJ
hIEjlJrZLRznRnwRyGoZiFq=cdgVaBrbFXtKTCjSxfdcxCnAljoyyJG
HIUmvFkJjOP=COrspOkbIqvvrbzpMjbXEd
HkmRJYTiEZOmXRXHRuRcvI=TFAquSphAblJZexUJlPdrH
hLLO=dyLYtAUztnrOnaNxoXRfZCVmcfXYHGl
hnG=zGGhlaOdpWKKOrTmCFOSvonJSyRESEZ
hSDuInEvQArzeuZcW=zUmwxkFDNzucGxPGsT
hWbnCHEJSmkVOjSHJlON=iOHCHyElpxfwLeik
HxkOZMxJSgCvVVOPLuYAodcuulmon=YEJ
hYLwgzs=PfcTzaKIblvCCmRuAZHPgAxQSMmLOV
IAUpkoueWKRrvtvG=bSFWwQXSNXiZRRlzgAyOGmJPEquNuqD
iBEbEvwTEvMQXk=quzsPHnsjjmISQhdfUD
iBtBDxBk=vLExSsKVOiYTjKbKsalteuyJ
IBYmSiilNbRZZKEh=EKnxHKTjeVmjeDoYVU
iDPtPXgwQPicXbHjJm=edpoVhzMrDtQCxcnvRzHorB
idVXXz=HvJKjHtIXqxvpBpwOaoQphOFfuwWhx
IIytWAKkSlxlYxiIKduawjsXyUNp=sLxQIQonfWiCkOpDMT
IJEjmBzHUEAqLtUwoaXIpsssxubPco=KhtYiaCxGVQEhiR
iknsalYVzNakGgGYxcqv=qBVxzzrgIrRx
iKnWYwOGESuXQDVBHOda=itRyOcwvcOnCtBGGs
iMPShXFqZyNTvse=TxMUAtQrvUIJKFpaFHMnkWMJ
IOgOpFUxFhQdTQj=fUXyhWuojoSVzpoRMqZ
iQRelIgbdLmpPpWOfJWTyXJWsXIBTC=aJPLNfqdrRVN
iSkfwlIVQqQumEAWEwV=SMpVWVlfngNSrRJDaTCrgfhnQrj
isyLLKJzmJAIV=gEFgaJvKapRFecQSFVNr
ITnzMFrAtRWPTZJAiokqf=MOcgcwTFupxKmsSqSdft
IXrTXEmkQaAPjncOIwIdHNFBuc=MzhhgJymoqOuvGd
IYXjpQQuRmoCQGpYtfeCkXwTD=vfSDFILCD
JaqjzoTx=BXrNnPuUsPntdTTkjAVpnFaYvbaX
jCGgGofrklXJdrDIb=JGPeHXjRuKPYGexJDOUNgluMnjnn
jFkkRcOQVHkTZuDnzYrqztX=CZMSjVRAeJuHMYxCWhDSx
jHcjpAAJiJvpmJXSjngbWrNgA=EehgcCnldpYpGLueutvrfEN
JHigNelxYKymxXtHLvDVmTWoTAlM=exJOjHMRGUIx
JIBjPwoihgwgNTqxLbClZS=fqDCEwauGWKHkDacr
JNIRxNjivqFPFVHApfPAHDD=kxjZeVvPhccbAeHwsPJger
JQvnhYVuvgsIp=ShroKvKbKKYzeRHDOZCTAxG
jRXMOjgJJYyhlQOfTONECQGSmEbE=SVgZAWbMmxyVBctHKNz
JsMEFiNLgoBBjQPFljFFZtFsfcSB=nUWVdyDulkwjRnCrRdDIRqCCjPY
jsoCkzUVSvWVliHRZTLR=MdljCCzREuSFPZLYWXY
JvFCOHewTbqYJDzfzAmwCpI=TSHPEBHnYoO
JvmREMEUTFugOrydKNvBckTkUvGl=SCeEqlhumAO
jvTBiRjjhTukUspg=lSyJnwvjAHQvupGr
JzzdebXUdmKBhmlRumpGmQJ=QkcSSYoclMDZLSnjWgbStdkCQqAAz
kAFaymocMor=ofGXwJOkgjMXjWDdgOhrGXIZrCv
KaPSfvCSYCMlvPGpcpYnUeBddlyrdd=mOC
KdkoMQuX=OszpuCyVzStZDkYIHBDKALKEVTzATRg
kdtSMgvDsdovTrVoJUOEaifTIyQlIG=FpBWizCkaKhxVcDjtSzxx
kdUdAGulKoQBq=KbrMVQTOyyzxPWPzQCzfjUuAfwNgrU
KETtnPkxlmvltZHhEyAQYIUpo=yRwvXzbSSDitFSTqBrRX
kGkYwVlfYoUDxuxugUhHWTo=KEpmpNuIozIyw
kGlJj=qNzdJBUbopcFRcZTtbAhGoIiPIKe
KIhaDhLnemsQg=prixZbPftJelWRablhugookeK
KInxUgBXb=pAtihwAgxmEhXBeBmelcnVPS
KmimgSOfrhIFyDWdyWrsbvSeLuRM=DfHJylmfPAVClD
kmjUyAfwu=PJemNeICMzlIqiyALHWilGNnxjLTW
KnuTVftzdvfZvSOSmEatoWiaIDeEw=TsCxMhYPzXjmuAx
kQycoCJCaCIKfQZCadLGTxTKm=qtATQuBIzEbxvvODMhLaV
KUQElgTUVeYnTpJeZf=tFtKLttFXbcIWpkwvA
kvexhsqPbchBJPxsmzbikGxIgaxjsA=mHEmPWgEUWOABsVLsqFl
kVMDyemEb=AmslafeFoVqycwjLwpXQRusHXcBOJGn
KvQAFxxuIkMlBdYc=bHWUEyesBGbisxZqaxYIMxEFtTQx
kWSGsMyridsGsLjIEPSij=rDOufEOeOcuPoQN
kYUgtVCjMhgLRUAjekSYKxVg=dwaPbejuaVq
kYZNJnUQNsCwQwKGZOk=BbSvhxHTeFfHZHgHfDOFpaMPUVUT
lCjrIYjsXnLKKsBQbtKlVbi=MHOSyGfjFZibgMc
ldbreeqUfnODQgnMuhiSKelhJpH=afvnmzFEmhORlHIzkLneM
LECrxAalnOms=uPArHZRVGMPcQFPjPCQKDPV
lFjeciuShGYrBx=pIdPUWubYlWufWmlmrQIRwiQQHBuOT
liArldYooNMaOkAFdZiYgfngxFj=meAFG
LMEyuYYvOJDFCjjoNsthixtSlIKn=fcZXaAsXjwCjDupjEcCBwyAA
LMJMiRjYWsBgIrpDrfgfDBtGSjH=NTVURHzzbcWMDylZKCO
lNIWdbPVwBCgJbwsgexBJuQeHGb=KTfmvcRe
LpqKRnKgOsctChORiF=jfAldquNIspCYUnMvCMJxC
LQpJmShqDfgaHWDJfNpmNC=wkYNaZXLhADzBrFXBiJWXtV
LsBMCBpiSrFQyNnXuvxEPGxODKt=rmLQaDtGBBF
lwJTecqbqySZUQaOab=dwiWJzJUTdCGPUo
lWnYTbikHYKefQdhSYhPQAnoVj=FkwKhsEVEqtuvWfofAzxnWauXVqOVKV
MARCaYVAkuOepBifDKhUkJnDsdYEo=WATtzRHsxl
mbefzvVDeDjiUduHHzrBLNaIp=sbCkCtohgqSlWUrbP
MEpMqfwyITETkHWsD=rFwRuMnSdfEOgbOrVOpxka
mHgXVvgDeDMQI=IdpIHrjwKgvkXLPqJFDrhrMYhP
MHrIHgciYPRtRZWyUAQuABVr=CUpsLKwMAjjYXftjZwGPHeCjWdiF
MIjoffxJDYNNAAjBAaZZsJPRTuJR=wSBwMKB
mJdGYYCDUSLOaslDLdUPQxdOd=jfyJIWtKXtxzlZB
mKohaFIxaFCMzH=myJFHQlGQQHNEQymAt
MmdnJSqYPBOCGOACbrfNpwnUwMrgj=NKIaBFxXFoLRKzyRJoyzbt
MnzaMKKNJNxJshvGasDZNPbxwak=BqrQMRXGpLnybV
MQxcWUGbvVGchbuEgHPklrDOIH=VhjSaaV
MTQUlTDEUykWOSvrUwMba=CxqjkBaqJjxeoSlThN
Mt=rpGeLOadGlRJZfqmjoSuPoZQuVLFjY
MurewZnDrPSVApSCCDvBVO=poFFYzdeZFjIeQRnrKz
MvJWHnlAuZSstaTKYrztpkDuAmh=ICcasxnUDKCSeEofBfWLBOmoBwuCKlG
MvZhqKuoaYVFUuz=CvKftnpKNezEytDXotTJ
MwFSrCE=QhFKZLJYQjZsboZqRYbCGGLeHTD
MyCJeJMUrkJnznWIELLWUr=xPLeBJoGsSUmAJeD
NaaTHNSFzoWmwzITZIbqXO=uSgqKJmJxWEVodeLRKqOjTFjDXsb
NakpbdeAHyDwGcwNAylNxVmpSS=fJuJumqcwfiXSDqIC
NamDNNnYzYhlhCLqWBCizd=JNAMjYnRWXbdi
naNjKJYzRRjyppJvOiekyjr=wRPFigizXZHOezVOnqKNhOJ
nCTBCeQQPKByslTAScRhrrTMAQ=ahzBlxnxx
neQxoNmILMleaHXpxZHzOYJnGKLS=GBqsZOuqBPGHE
nEZqruTicm=JzegkivGoPxPqWgusyBTplzbzy
nGqIoYMnCnLRlHtSVrdmuB=RpfikrEElSjueKUrCxUx
NHReXnzMwJBnnAnnYJ=rWkKKPfwFoOcAUZrJGMzAbHoEKwpaYk
niHPIgNeiHsCyKX=GcYydaZfUobSMSYvf
NJlEcizmsOTVyGjQwuPW=kSInrZCHlzuYcvz
NJxLWludHZzHOEOwwZYFTiqDe=yiSdNzfvcVJxwv
nnhtKzcVfGSIHJk=fsfYJZTfAwMPYdLrcxKktwZkM
noGiPtNlwbKUnaDLrZOduVFsMQ=nmJVGEauXJSQHpkuquCbpFsnmhO
nPICotuKUsQzPupfleCUCcetgnYYzx=lJNvG
NQgzYnjLsvNsey=ywdMaqyIPijyZEJGIXPtBWpqHIEynVs
nrhrVvpFfFiAHGazcxZzqyf=sYpAgLAtWstp
nrrnorWFluTRKrtjxROWdNZELVPJV=sTBhYB
nSkpYuhhjegDgNSCdcYG=XHDLggsWAhEIn
nTadzVcqTVihbM=LkRzAaDujKoyWovZhpmHwLYnzeAv
NtjapWiMUEbLNjtyVnIaRonJ=fWoSBaKNLxbcfaloJFMpZowXJNvtO
NtneYjPRIZBbrxANVVv=ctXEcCxMqIidB
nUeVZEVYIGOFvVQGPSs=xBlmARcpjPaiJFLG
NxKjjvXDsrlFoJhQnipVaplK=ZLFcJwgIFFsbpBRI
nxxxXfdQvpaaOHNzUqFcG=PczOsabrIiymGt
NYThft=tptrkvrZZrFXVKVsKQHvIIIaDlW
oBTBDEPiVpGVYDhlMqIwbCaOD=KFQicrWaWMarhnTjsmMULhbsEKzrI
oCgMGXELCPEtRKkdVqiSy=RdRpoggmYqkndesnl
ocqrgoVMRyTWjvRDOcP=CuiCYYWRSyNAopZrXpjVTipJyLfoEk
oDzQxGcVJEyrTijBHvqEKZCQKTjEv=ruAdJKHU
OFLbMnRPUWvdYKpuaGsafPMB=zZxtMnZiqzlIBFOPAJGvQyl
oHTNuCCOeIrZSJqpniv=fyxvcGKCQKPwYNlbKcNwByb
oHZAOypvChITaNQOTAHSECtBnxPtZ=afxjtJpePNWGuooWmRCGdNnhg
oKokDYDBOflMXkO=WcyShqKmRemBIlTpaRGCxVuewwfvt
OLrWYYhD=jYDnHlAdFUcDqwhJQAXICEWOU
OmqWUzotJCrymsIpBcLIxPUrCwHHO=kLnziobeHUNIVOYyVYCvRDFrlpSyyij
oMZNRDZKZLLjfMHxDCwkwyGlWGqql=YbbpntjNRqKq
ONTrWixecdNQYyAJUWfIRqQQ=YfNJFZlPLdsAD
OoafdbLcrsCAEjdueQrFm=FfuafXFfFjpgJoWwOqEwuix
OoQkIeuXbiED=RtrfatzragWGCJuYVuQQJXGg
ooUyovooaBoSpdxcXCURAEikciK=UadJuOZpub
oPCSKpHzKhqBNnqegQdy=jlmFdJcTlSlopRAlHqlOQOdemW
OsMHuGPytwQmyHMsHvLGDcohbp=MjcYKbINPbucblztqWqFUBlTl
oVhULBihjTngisnESufGyjy=TBDBVXKOkbOCSOpHGrZDILzAfU
OxezEzUUEeNuGDlOrykbMdvKdas=OibonItaGLqs
OyJTjZHEuwjDDsdiIQOPd=XwPvkbbpKZdwnqzmFuZzvJArMN
oZHNIpKxDesgtKAkhXfZEHLzU=VaqXEkvHFKmgoJxcrvCpDNBB
OzmZtPcOHQpxTbfCqKmdHaO=AYPGiMnFUSRVgOzGvnn
PCUsKynWPHkXhTDb=rtSswGunlrOUhGQNdjCUkfIvva
pcWrOvcOQPbPkm=wtuDLkSbjnWpEDgkXoMJNNeQREyaN
PdsDhCgFhHDwuiboIigLcII=SAQCNVzOUQPWBntwbOQxyVkJF
pDZyciiqqAAY=XnZerEDydArpRonbNVocJ
PfIMZCBBqgQguOZovZrisidFb=iSfdrGs
pGpBnicEvPwPvDnFLTCSMyJqC=iVLFXwuD
PiAsAlOAuKcwlcQntnGHtkUzrxEBur=waNowLTPK
PicHVaPaxRCWf=QSlZUTWFJqnlFpZGILezGOUzpeYJd
pjcgGHWXZPPee=qfEoGfQSNKssPdkCmZcTwIWc
pJuonrGAAOEeAmTiqrNnlHDTtC=aIedwNhOODAgAqVEyyoSLjhuUDlhR
pKdDFvoeAtqRpGaoagFRgPLKFfuMot=FTihWDiHijCUGfaCqRfQFOfNedcOAZR
pkIizrRBKKbswHkmuVeLoWRAssfnbw=SFlzQO
PlkYblRXisGxAkcOC=JGFzaTnytSToQkhjelxyteSpo
pnruAGgkqWFBqMpdWjpYj=zuDNcEZEPOVtA
pOTwbGOGstnhdXWVDBEPvyXGZi=jabOey
PqeGBppCykH=wcsqizhkHfNpcXZcMQdYbibyk
PsxpEtBnUDpalBcWRNOPl=XHKMIdxvMDaKBQVMoxNOT
PvVnFLlwABP=VFlrLSkjbckEAHgjXsEdkYWpwWXNea
PweRrmaZIUBqKzRjPDzTDyWlnzY=PWVruqxpSAUJjPbFpAowbYLQsBToFl
pWWQlyCSDgNlVVVJ=NoemmCgnpirnaKIhkOjwkhwV
PXhboQeVSyQldxiWUufoC=XWabOUdvQBvEBJSfaEcoUrBqrQjm
pXTqlyGzSrYgvkboiFbpPhUUiJgLg=KSEjxcbiAydSGpFAcaRQ
pyyPXoCUAXTkIqhhPiqpePUglGhVmn=qjLtgldANZnEkuwutSTivdp
pZSWsvutlrDjyTXUdLCrLckLbpJNBn=lEqDcPlb
QAIxvwVtsEkTdjwZDpvQnOQkk=dtLojLWHDfhMtzXZBxG
qbbQErbwKuJILwsGiMcs=KnoGJdtLAyCjnhNdDM
QeGNItUfUGrgTODxmYxSz=kIGRYkClVSgLTADtSPRfOMRm
qgaqqehkOQiZpOt=pIHTVdqAKUSBDYCrBuNnzr
qiduBAgSKIyVVLhrdjvuhviNfAW=IAYKMdZEuLrHTeTscLSJKNDUj
qjrcxdrWFALcDbLhggDz=GVRnKUEJIrhZEkgtEjfR
qkPFhFbVzvstQkzwectQLWCFuS=aRpSKrJFzY
qMZISDdzbAkoBGXfEdU=UgqtCiTvtsflyqE
QndecrjoGavQWjKhuOxnwIhVKWaNH=pnmrPxNClLNzIWUcAbQAcCRvGpb
QNLeoEOkWb=XWPBGmNwujVanBdihcNwcLvTXkj
QPAzUkrpACkpRzNFWrkbCReZrmQt=SZYVC
qQuunfdUMZ=CunUuecJJSVNaaflDWCjHZBRB
qQZrLLOMlpgFak=kwXBlYSAKwdTnzVDdMbYavZr
QsTPNIZXGmoVtIBVLlVrvNSyrAPHa=tXZKJjEKgYAlZNAH
qvlDWBqClYQs=MWhFByRRGvzrTUtzaimU
QVsMEJpuACpbeSANz=jdOqtybIPERShRRV
QXvvigNOIJ=OtQHBlgIKJjFamoAoJEccHqMmHco
qzOtQZSCGUSRduvjf=xVBJtJnGxbsZwGniPYQ
raCjzgBCibnmLqDBpvMv=WTMvTMRKhVhGQcIiOtElhQabtBrrcE
RbApGwQcUvbALmFOfVRtZXxyMZRsti=zrDkOMnNtn
RCCaNx=vcihnnEjFtJWPyYUdjChutxnaP
rJcXJWWgBLuvuqZbEYryjUkrtPlkvZ=RqbWfJoymcWWZJ
rjDby=XgWEpINxvFaYdLTqEeAxcSDEhBENWjt
RJFfygpymJknHuFMwMTo=kdmVAhRGvcatEQPNTIkgvgvAe
RJwVsXsilNoMEXNdP=YUDyREdkydtDfrOLyGOyCpPl
rKNsOxrCbbrAOJpLgzXZrrFgPHGsaW=sBxTzjbFfACmbilObOdHLpIrJVVc
RKrFDRLtVsRpgnRmnBRdNoXEWmm=RzBOHMgFuSFYXHe
RKWwtOMtzMJzGsT=tVZUAjvmBPKaQJZWuApruuIprM
RpfQRnEVhnWfughkRfvV=RwcjvqIYEJJATFjdVjvAygxrLMTaJ
rPPPIRUqZnaHgMXNKhl=GZviipDIpkFSdUNHaC
rRBcbTBnuLmyivTiqYXsvG=OzCWLXKWGPMsESOiqLjmDfWB
rSypihpKSMVRaMhLsKdhHkRGTvNx=ImHtstCY
RtYTrgUMtXbqiMPQkijezfmp=jXIPosHOytHiFNS
RWxWVEbpKcECTmJWxBMmQlbDBm=rERXeQRFfok
RxhVsYDdhuCvtOmQwHWCqw=zGioRGjuBRbl
RYCAIWIlNuEQAfFDlmlmKVRmOQvQ=vbspsIHAqZgkMhRXhARNsPLskh
RYlLjUtRO=ifNroftyHKmaUUCIxVXADVnQTW
SEkkNPAfvJevekkljU=NxpLRVKsiIgBwzoLoQajxhjHjkpkG
SGAfHmMWmJQTxQRoR=vNubaQpSADDoVdrdT
SgQpzQlsNjJAzqBA=auuqjYIRROJSYJWJjxpEHNTQN
sgTvFhrsgFxnnhJlFBPYPDrtVsl=ISLmnwKbAlurzTKQuJ
SHYnYpAkkNtnWgpcQbv=GtTspjhlIEZBOaXHAWP
S=JrwaJuGzEQqGCcFFDrtRyLhuygXZiJe
sKxhtgerJNeRGjtbIIfcLpbxoq=JyUvMoyRtwBWOuHOPyf
smpTEUeXSSWfHCorgvYqIC=YiLISdOaABudqtRvqJVnHBESC
StKBQowZTDFkeLSnEWcgNKosLAcC=LtGs
sueyWyWAIjemhnaLStOmJNg=vdGtQMbyjblByS
sUTUitFLUtjhyPGBqMLVXlQ=QbKBlFMaYFykddMo
SVdUVTmpvGOpkfaQkykOaFAZBD=scQRTxpPRkimazJskvUFGcXNorWcVf
swgtzasrbgkLuTaJZIZpWQ=BRflPKKKCfYdsRcuedSJsfZUwmBjhB
SYlIvpvbWutYstxuCuKIumDZqChpb=NiVbdKkjRJzyN
TabmQOOhWopekXi=ToRMthVKfLFlVtgojjQunDCbyQc
TbtPwtWCnCLSpOUsGJtv=nsTkqCLRTxfaCb
tcEIFjJOlzLWfyohYFsxgHkSXKV=fVpJOrzfZxSwmbaFzVwkygSR
tCJVnKKDPyTrQlcywa=enFLRiPoxAxUnzccAOZ
tcVWbdjBCYkZumBBSWgtNsUTy=lScwOKQwsFcnBfUNHGryXgchD
TIrZmFaVnWggMZXHbmUlnfqxzGrfWR=GGUxRicqmHM
tJLNlgStxziudZOLEjcsWqtW=xRFqCVbbkuVICJvoOVnAxcWCuK
TJrsJxKcEcTStxjkQO=IRBvzQLmBSuZvrIcrOPLrSjNMria
TjSGFzIFTLxZSKiPgopLiuiwBrfb=xryLrg
tkQMhlUsJeTeXITNlAXF=waKbInnkrSqpKzbaYdrCeEBXCmSh
TLBJHpeqgKJsgjjsJbhFuRijzlJa=qESRyFzSAg
TMqmRwXWpnXxrruKH=edHLvwKpRfJTDJAHKdtVMmQ
TNAbkUDkIRETiXnKvE=wGfrcNOkkCuQcs
tQiPYKypjiuemoooUDuQqMswKvuG=UiuzRWpXlWLjZuD
trpDJzQHyyGTmZkXURR=lpHXauRiudIrxeIlOyDRAD
TXBmjbfaCwIyCLxynQb=xKdbmCDqMBSnoH
tXNeUPKyaYswmJfRDgnHtPorvYo=GQDJIhzgsldjbmaXZUWeiAGFMX
UcxqPhE=ECeNxAxqHWnrjsaRQBzEIRvIMgihh
uDJcXLplMThgyuMwZYbqyK=oJSKKSayoMslka
UEqHluEFvrQXVdxI=LmpDHUyawlWLzqxyDvotlRT
uFFMCkevCFxVVWoXeiHcJbzwgof=wqMxmXpNA
ugHWcEaOWbGpaDtiwpCVRVGFKgw=jULfogpdwPTjvzkluETk
uGnWoS=AyHGJbmXAxdjcRnjtpRjruciOfFIl
UIzwsGPbAIBiEWibSscLPlIlvoEPcB=foNFpSHUkUXvgHDNo
UjSDBBIuBiOwfSPzfeNGa=AmxOOPpUqkL
uMUwhWEfBkIZXyvyjSpnBJrdkiTjI=bBLhBIxJZjuHqohVQbodEqpyjyDNGC
UMYbiBIKhUgVCAYfebN=uSPtTJHKHUYKCFjTYVaCqAVdX
UPXDurgKNCJiYkOkuOYWJCyIBETfM=OJXxYlkEzJbnDtFZmkOtTfudxTOc
UQkbPJdXhMgUVAgUZSVXhTZWoDbtk=NHXKrIHLyQzsqNnJfjg
urrBVDRdOUcVpVvDfTrMJNhIOo=daZRcdOw
uslvFNDmWQkWeovraQYbDHmJFlRaQ=KZlsFLOkCIB
USTuxSfhaOuWhCoTcW=COkNwcZRDgJcteBxFixRs
uTifNSHmRTCjrlgxlkdXSsjoDBhnhw=iOSvcjHdyMjoKDSmNWGKzWMUEFRBx
uUmujoQeuVLknAclxDFpdtOJVgkPv=GYdbEJLof
uvJznkFvjrFlDrRosWlkcnmJ=OzsvjAUtQyrEiZAEJB
UyWuyfVtbeLgyLAjlobapL=vRnuWkShea
VAPNuussRPbvafMTcaZbbgyQM=kUEfYawfAMTYtLqZ
vBxgNcaxvoJGqLQqFrkkEggjtIfG=RESYpSMQPBTYCEPtJgmQHZryJGsGbT
vDTuGXOkSzeqPKVowDTCNXwbvAg=sEymQNXljtKGFAKqrbKWCRWhUuoq
veXmXLcyZAWNqDKVB=jySollbdWHKTFUaoSZumcKCwxmMDQ
VfsIVBofEgxqxHdgsmFCiDVqO=GrnZNIHccfvPqrtpzyGzgiVriBf
VfszekDzPAzmCBMswbkLmUn=ZLYGmrZgakhQcyFuvrcYVhXE
VgJkxmUrLElathatXxSmS=hpWBqIZeXQbB
vkJKelgusUDUlFnxHdNfwvMT=nHIJyuNWmLpR
VKPPEdBrJbT=kvBhZAyYdHtkLPreGXpbuHthfcSzxFU
vKUBPAOjKcpshwrJOhqwLddpEVr=mUPmJIKMIcaaXrFiaEcwOl
VLoHenGvrpDAxFwbAvHKfXk=ZDSPXHsXH
VlpNEXgreN=QmkiSHLtQeEcKgFJyrGEGsUGITGIQ
VPyeVUjLhTRzMWJYrgVzVlND=BeKTvexYBeUTsW
vQHtgcsybNbmJQ=CLSIdJBMvTucqBGgGcqCt
vTIdixORWWtC=vzmzdLSSFsXQggGXGNMvxjRILljS
VuGgTHdfRiHVyvluHDULvtZ=DzglZxUaQozxWnmeIeNSsrZikfC
vUMUIlFTMmVXFjJPGgTLHBqxq=gfZUsHulupRvucWrhbWYsKWcKCJjuAQ
VZCMcsZinSFH=AeGrpvDJsecbCeqdqymWhsPJqbDjKH
vZlBjJeVICnylQAPKokyEdQTOhjjro=ifCDWSMpPDvrrvWmLOyhnGNDWlu
vztgIYhoqXTIRlCeCZMeWkyRgoHly=DVkL
wAZRqYrrts=KciCbAfxDduAOjvFfhNwZDX
WdLlbkJCoVOePzEPJKO=EdsmmUbvNzjvyhaRLTZxTgBJPSHbJpv
wDuLYIKYnvyNzZhwSFzjNSeLpx=DmcJDaIcySrICICmZOECIQe
ddr_refclk=83
wDxFxYKGmLhYWrFWs=DAdswTCklUfHVwlAdYLMaQUnHDc
wgEYVWQkgnBqTJoVaVcgOI=NBznpusSdOCJRsBrHslVUuYnkq
WIvORszaSrBxrIxa=mjYvfCQRtxgZsNCbA
wiwAEBjiwcrQYAWfyhlVdxechWfN=rfUxOUgYZHuOQdFcbyskEe
wKjskvBYfesapKIzsoAdjfFGBtkFf=rCtqvpT
WLKuiKwz=PyhUCJQHsrODdidjUtxifVsxWOoHE
WoAANLAQqFfy=lBCFCjhmNONoAuUqNBSBdotccZTOY
woKqkPkSSvukQNvg=HLlfJVNgazmOvRDCnMn
WqOTAcXYUPSIypqLjIQQPilmvFUGR=UJAoHYLmWCushzDwHwEDYmAgcJEiT
wqvwdsrPwlaGx=zMLeYkTMXdCfkSMEhgcGQOvhBBpSdsW
WtxoeqZMfmsdOACEjoVjm=YxcEhhcPFVPTWCVc
WuVlpxyvZPEEgOuuDsL=cQlaqeYznLCXezAxNBdqAPcdzRzoY
wWGrdhSexjqJCciGsVYocO=npjsMFETECNRozDeTPdYlNFUDuh
WwymxIzgQwn=aQUZnJSaWoGpuQeglvkdyqVAoykP
WYJAiOHMJBAtEZUKceRGiBCRv=OCtJTKOkqkHHYoiLesAgNb
xBKpuQDBYPYsyMnIpziZdKvMHms=AcHgsiAGKjKuP
xDpeiDDMctsWqHbYiCohPbUsGeyHUC=ddOhSroUUSxuVWEBbMGOzQfrSSrduu
xFGAKXTqfsuplLuFRuavuqys=iuTWbuHJokqJkuCsjfdtv
XGADuSfSgXbQRmtoJ=GBkqZCDOEVmrSIDlhylfICTxWNjAWdQ
xGZbLfkWrMngvphdpKmDCpphzpF=hUtPXgE
xJxPYiq=RJOYmkmjUwZTuYLCikAkAvbwkpoF
xjYPfeAGAh=DfCPqKzgAVuKISOKBYsJCaEW
XmOTWHSjaLcbbqOBjmaEiTyGc=oNblOXxcQlzi
xNgbUjdfiBBhCnY=JBhnijgoWKwDUVpMjVyFMuB
XnqsJuJkxrNYPQjvcraTMa=GfromutKOor
XqYZLqptNpPIiDoqUv=oPoqkKFspaMhVxRkj
XSWbPBzFVivZsNdLPcKBqybjz=xWArTwtxfLJPl
xTqxSySPYD=UqUKCwWoUKCILCPNZLuQakVHADZOUw
XtrYCpiOWVKiVgMPHjIfjDPWEVIVr=hHqWbTgaEttgMCXAsvlilYM
XTYyUQkCMZusfDRBbBYOFgFnJ=ZyYODjpzpvVoMWevMhVuDSIMxATw
xVoYRdoCiXLqRMqnPqIsyGFrXvfwkG=zfEVAiPsdlHdvnyOSbJ
YdBpbTunWxQtrsiEPS=BkbIihstCnJJuovXuIholVIvKgy
ydmgnbFDfLmXXZWjjEsFBvhfReF=jSXLQqSAxAUJRrHRFThtnsj
YfoVvADokJWAXwlS=qTWbPRpoMTtVkebXfwukb
YIJbWyIxHBJLEQlvo=XUSozNPQuRUDADC
YiwHo=HucQxVeIxgbvifbkTAnOmdsoEoFSd
YjapuBwh=mvwRxAFEpqOgSBBTkpohiZFCMHK
yKstwZaiYyseNd=WcYNNlYBRmTYaAgiLvVnEyVihdX
YlUJAhTExLuPwkqXh=ElvnGKTmkhPJYCbFcPbbNAsoomHMEa
YnAjtzNTsCuyVJXPXFEeboSmTjWt=uIllJxjHFruqtOoeZNVzb
YnIMEJHEkfcfxdW=xvKGwmHjmeTOaMZNUB
ytKafeHvu=unOgqioKyLkwKaWEZzGaOdkWOanBCt
YXPQljnvlHbGRkseQhiONGAiXDpm=lSAZEYTxQFSteIAS
yyydNmGCbheAVaOcouhq=SwAGfXoOmUhKRnXDDoycBun
zangfbQKPceoWeXTkvVdrTc=SFFTWXfYvOeywZYDNyfu
zgffXtMWWatJOwfxzNHIPWytjAnjGG=vteNZjH
ZhQeCvjRuVXiKnl=wMpRriYDorKWiAlbaUUWoxkUyabB
ZJyReVhamlS=vyhbKvShwfZSFMUVFMWOPAxn
zlseRYVvEGkKZyllFAtaoHncIxoNlL=sIKganZONQFxVMfdnEecwqdlT
zoqUHVrbBFQLIbMQkZuPNbCo=VDFaBXRgtPjlwWiPYchOaI
zPovRsSZixQVeiUzQZmsLesXVX=VIxHNlyKIKjcvQXkRRKlyd
ZQUfFwduPuanqdSumheCQTcUhICmx=MnqPvhBQKxivLUPGGoMnUyqy
ZrMepUeTdeWqYFoHah=gXCBPGkwZwyPhjIeJheGQNAHEy
zsYSc=JecUrYVqPiopPWQtsRsicpiZgvgOnm
ZThpIKEwfptxGinDYpVXFa=AqyWVGNEjOnUEOthygmzVUUCOMhmfoB
ztRXtEDWbOowByetFxZ=aCTZXixoNLGSSWjYpUiVkKRatR
zTychLBwwZYDjrBgmCQ=VnsuZIrDSKQhDcZqe
ZV=bUCNQmZlFgrshsXLlhKVrnkJOqJGsQU
zWXJaNEkKOG=qNztfchfxAwcFsVXMlNsWesniYLbR
zWzLOoTGSgiK=jgSwvGJboZOdisBoZPPDoS
ZxItpYsGBawzMqlCDASjjJRaR=pqtDcMcmbbhYSjzzoHdqCvytIw
zXOFz=GbzqtXZBnCLByTaKldSxoRAHqbt
ddr_type=4
zxvhvZplugEdRPrWjMZQkubQTBq=mODwol
